# Converter
ANQ = "countries/Antioquia.txt"
APP = "countries/Appalachia.txt"
ARX = "countries/Arixo.txt"
BAJ = "countries/Baja.txt"
BKK = "countries/Beikoku.txt"
BLZ = "countries/Belize.txt"
BOV = "countries/Bolivar.txt"
BRM = "countries/Bermuda.txt"
CAL = "countries/California.txt"
CBN = "countries/Caribbean.txt"
CAY = "countries/Cayenne.txt"
CLR = "countries/Colorado.txt"
ORD = "countries/Chicagoland.txt"
WDC = "countries/Columbia.txt"
CUB = "countries/Cuba.txt"
DEI = "countries/Deitscherei.txt"
DLW = "countries/Delaware.txt"
DES = "countries/Deseret.txt"
DOM = "countries/Dominica.txt"
FLD = "countries/Florida.txt"
BAY = "countries/GranFrancisco.txt"
GLK = "countries/TheGreatLakes.txt"
GYN = "countries/Guyana.txt"
HON = "countries/Honduras.txt"
JAL = "countries/Jalisco.txt"
LLL = "countries/LosLlanos.txt"
MWB = "countries/MidWestBrotherhood.txt"
MSK = "countries/Miskito.txt"
NEN = "countries/NewEngland.txt"
NMX = "countries/NewMexico.txt"
NRU = "countries/NewRussia.txt"
NRA = "countries/NewRussianAmerica.txt"
OGN = "countries/Oregon.txt"
OZK = "countries/Ozarks.txt"
PNM = "countries/Panama.txt"
PTR = "countries/PuertoRico.txt"
RED = "countries/Redcoats.txt"
RIO = "countries/RioGrande.txt"
SAI = "countries/SanAndres.txt"
LAX = "countries/Socal.txt"
SNR = "countries/Sonora.txt"
SBH = "countries/SteelBrotherhood.txt"
SUR = "countries/Suriname.txt"
TCR = "countries/Tachira.txt"
TXK = "countries/Texarkana.txt"
TEX = "countries/Texas.txt"
TSK = "countries/Tuskegee.txt"
URS = "countries/Ursuline.txt"
VAL = "countries/Valley.txt"
VRC = "countries/Veracruz.txt"
WIS = "countries/Wisconsin.txt"

# South America
CDB = "countries/Cordoba.txt"
ECU = "countries/Ecuador.txt"
MES = "countries/Mesopotamia.txt"
VES = "countries/Vespugia.txt"
PRB = "countries/Paraiba.txt"
BIA = "countries/Bahia.txt"
MIG = "countries/MinasGerais.txt"
RDJ = "countries/Rio.txt"
PAU = "countries/Paulo.txt"
AGR = "countries/Alegre.txt"
URU = "countries/Uruguay.txt"
SLT = "countries/Salta.txt"
PGO = "countries/Patagonia.txt"
ARG = "countries/Argentina.txt"

# Europe
BIZ = "countries/Bizonia.txt"
BWD = "countries/BloodWood.txt"
MEL = "countries/Malevil.txt"
TIZ = "countries/Trizonesia.txt"
LVP = "countries/Scouse.txt"
TYK = "countries/Tyke.txt"
GOW = "countries/Gow.txt"
CVL = "countries/Chavland.txt"
GRN = "countries/Greencoats.txt"


# Africa
CVD = "countries/CapeVerde.txt"
KTG = "countries/Katanga.txt"
KIM = "countries/Kimberley.txt"
KRZ = "countries/Kurtz.txt"
ZUL = "countries/KwaZulu.txt"
GQA = "countries/Griqualand.txt"
LBR = "countries/Liberia.txt"
MSE = "countries/MosEisley.txt"
NGR = "countries/Nigeria.txt"
SEF = "countries/Setheefrika.txt"
CBD = "countries/Cabinda.txt"
DRC = "countries/Kinshasa.txt"
RCO = "countries/Brazzaville.txt"
KSI = "countries/Kasai.txt"
ANG = "countries/Angola.txt"
BOT = "countries/Botswana.txt"
MOZ = "countries/Mozambique.txt"
MWI = "countries/Malawi.txt"
NAM = "countries/Namibia.txt"
ZAM = "countries/Zambia.txt"
ZMB = "countries/Zimbabwe.txt"
LSO = "countries/Lesotho.txt"
SWZ = "countries/Swaziland.txt"

# Middle East
ISR = "countries/Israel.txt"
ASY = "countries/Assyria.txt"
KUW = "countries/Kuwait.txt"
ABK = "countries/Abkhazia.txt"
OSS = "countries/Ossetia.txt"
AZB = "countries/Azerbaijan.txt"
NGK = "countries/Nagorno_Karabakh.txt"
QUB = "countries/Quba.txt"
ROJ = "countries/Rojhilat.txt"
RJA = "countries/Rojava.txt"
BAK = "countries/Bakur.txt"
BSU = "countries/Basur.txt"

# South Asia
BOL = "countries/Bollywood.txt"
XMS = "countries/ChristmasIsland.txt"
CKI = "countries/Cocos.txt"
ITU = "countries/ItuWan.txt"
PNG = "countries/Papua.txt"
ZOM = "countries/Zomia.txt"

# Japan
AMK = "countries/Amakusa.txt"
IKR = "countries/Ikari.txt"
KOB = "countries/Kobayashi.txt"
KRU = "countries/Kururugi.txt"
NAU = "countries/Naushika.txt"
SHI = "countries/Shimada.txt"
SUZ = "countries/Suzumiya.txt"
TNJ = "countries/Tenjou.txt"
YAM = "countries/Yamauchi.txt"

# Pacific
AOT = "countries/Aotearoa.txt"
AUR = "countries/Auralia.txt"
BBQ = "countries/BabaKiueria.txt"
BHP = "countries/BrokenHill.txt"
DUN = "countries/Dunedin.txt"
HTR = "countries/HuttRiver.txt"
HWI = "countries/Hawaii.txt"
SGP = "countries/Singapore.txt"
SPE = "countries/Speewah.txt"
ULU = "countries/Desert.txt"
UTP = "countries/Utopia.txt"

MUR = "countries/Muriwhenua.txt"
AUC = "countries/Auckland.txt"
TAI = "countries/Tainui.txt"
NGT = "countries/Ngati_Pouru.txt"
WEL = "countries/Wellington.txt"
TRK = "countries/Taranaki.txt"
DOC = "countries/Doclands.txt"
CNT = "countries/Canterbury.txt"
NZL = "countries/NewZealand.txt"
