CST = "countries/Charleston.txt"
HOU = "countries/Houston.txt"
KOO = "countries/Kootenay.txt"
UUN = "countries/Uunaay.txt"

# Atlantica
HUD = "countries/Hudsonia.txt"
VER = "countries/Vermont.txt"
NBW = "countries/NewBrunswick.txt"
NSC = "countries/NovaScotia.txt"
PEI = "countries/PrinceEdwardIsland.txt"
ARO = "countries/Aroostook.txt"
RTG = "countries/Restigouche.txt"
AGH = "countries/Allegheny.txt"
RHI = "countries/RhodeIsland.txt"
WMT = "countries/WhiteMountain.txt"
MNE = "countries/Maine.txt"
LGI = "countries/LongIsland.txt" 
CTC = "countries/Connecticut.txt" 
MCS = "countries/Massachusetts.txt" 
CYG = "countries/Cayuga.txt" 
HVL = "countries/HudsonValley.txt" 
WSQ = "countries/WestSusquehanna.txt" 
ESQ = "countries/EastSusquehanna.txt" 
ADK = "countries/Adirondack.txt" 
CMP = "countries/Champlain.txt" 
COA = "countries/Coalland.txt" 
JER = "countries/Jersey.txt" 
MRL = "countries/Maryland.txt" 
TMI = "countries/ThreeMileIsland.txt" 
BLT = "countries/Baltimore.txt" 
PHI = "countries/Philadelphia.txt" 
PCM = "countries/Pocomoke.txt" 
KIT = "countries/Kittatinny.txt" 

# Great Lakes
GRB = "countries/GreenBay.txt"
CPR = "countries/Copperland.txt"
SOO = "countries/Soo.txt"
NWD = "countries/Northwoods.txt"
SUP = "countries/Superior.txt"
CPW = "countries/Chippewa.txt"
IND = "countries/Indianapolis.txt"
CHI = "countries/Chicago.txt"
CLE = "countries/Cleveland.txt" 
KIK = "countries/Kickapoo.txt"
OHI = "countries/Ohio.txt"
MIC = "countries/Michigan.txt" 
MAU = "countries/Maumee.txt"
MCN = "countries/Michiana.txt"
SAG = "countries/Sagina.txt"
DET = "countries/Detroit.txt"
UPN = "countries/Upnorth.txt"
GRY = "countries/Gary.txt"

#Canada
THN = "countries/Thunder.txt"
SHD = "countries/Shield.txt"
TOR = "countries/Toronto.txt"
OTW = "countries/Ottawa.txt"
MDL = "countries/Midland.txt"
TAL = "countries/Talbot.txt"
HUR = "countries/Huronia.txt"
ALG = "countries/Algoma.txt"
TAQ = "countries/Taqamkuk.txt" #X40
AVA = "countries/Avalon.txt" #X42
STD = "countries/Stadacona.txt" #Y64
OUT = "countries/Outaouais.txt" #Y65
MTR = "countries/Montreal.txt"
MRC = "countries/Mauricie.txt" #Y67
EST = "countries/Estrie.txt" #Y66
GSP = "countries/Gaspesie.txt" 

#Northern Quebec
CTN = "countries/CoteNord.txt" #X43
SGN = "countries/Saguenay.txt" 
NVK = "countries/Nunavik.txt" 
EEY = "countries/EeyouIstchee.txt" #X66

#Hudson's Bay
KNR = "countries/Kenora.txt"
ARR = "countries/Aurora.txt" #X68
MUS = "countries/Mushkegowuk.txt" #X67